Station,10-17,18-24,25-40,41-59,60+,Unknown,Total
138 ST.-GRAND CONCOURSE,0,13,26,9,2,2,52
149 ST.-GRAND CONCOURSE,3,96,190,81,4,1,375
161 ST.-YANKEE STADIUM,3,89,190,116,10,1,409
167 STREET,0,25,43,27,6,1,102
170 STREET,1,69,156,49,2,5,282
174-175 STREETS,0,7,11,3,0,0,21
176 STREET,1,55,66,28,4,1,155
182-183 STREETS,4,52,66,37,3,0,162
183 STREET,1,37,62,28,1,0,129
205 ST.-NORWOOD,0,8,12,6,0,0,26
219 STREET,0,7,15,5,0,0,27
225 STREET,2,15,38,15,1,0,71
233 STREET,0,1,7,1,0,0,9
238 ST.-NEREID AVE.,0,4,2,3,0,0,9
241 ST.-WAKEFIELD,1,10,18,8,1,0,38
3 AVENUE-138 STREET,1,18,66,29,0,0,114
3 AVENUE-149 STREET,2,53,103,44,5,0,207
ALLERTON AVENUE,2,5,15,6,0,0,28
BAYCHESTER AVENUE,0,4,6,0,0,0,10
BEDFORD PK. BLVD.,0,4,5,2,0,0,11
BEDFORD PK. BLVD.-LEHMAN COLLEGE,0,5,5,5,0,0,15
BRONX PARK EAST,0,21,40,13,0,0,74
BROOK AVENUE,0,17,23,10,0,0,50
BURKE AVENUE,0,0,5,2,0,0,7
BURNSIDE AVENUE,2,47,70,30,1,0,150
CASTLE HILL AVENUE,1,7,28,8,0,0,44
CYPRESS AVENUE,0,1,4,1,0,0,6
DISTRICT 12 OFFICE,0,1,0,0,0,0,1
DYRE AVE.-EASTCHESTER,0,1,0,0,0,0,1
EAST 143 ST.-ST. MARYS STREET,0,1,2,0,0,0,3
EAST 149 STREET,0,16,20,9,0,0,45
EAST 174 STREET,1,17,22,6,0,0,46
EAST 177 ST.-PARKCHESTER,0,32,53,15,0,0,100
EAST 180 STREET,3,88,136,45,6,0,278
EAST TREMONT AV.-WESTCHESTER SQ.,0,1,3,1,2,0,7
EAST TREMONT AVE.-WEST FARMS SQ.,0,6,15,4,0,0,25
ELDER AVENUE,0,19,25,11,1,0,56
Fordham Rd/Grand Concource,2,56,94,39,4,2,197
FORDHAM ROAD,2,22,65,32,1,0,122
FREEMAN STREET,0,5,14,4,1,0,24
GUN HILL ROAD,3,33,74,26,2,0,138
HUNTS POINT AVENUE,4,56,79,24,0,0,163
INTERVALE AVENUE,0,19,25,7,0,0,51
JACKSON AVENUE,1,17,31,5,0,0,54
KINGSBRIDGE ROAD,2,20,32,20,0,0,74
LONGWOOD AVENUE,0,6,5,0,0,0,11
MIDDLETOWN ROAD,0,0,2,0,0,0,2
MORRIS PARK,0,1,3,1,0,0,5
MOSHOLU PKWY.,0,5,7,1,0,0,13
MT. EDEN AVENUE,0,24,45,21,2,1,93
OFF-SYSTEM,0,1,0,1,0,0,2
OFF-SYSTEM,0,1,0,1,0,0,2
PELHAM BAY PARK,0,1,2,1,0,0,4
PELHAM PKWY.,0,7,17,1,2,0,27
PROSPECT AVENUE,0,20,32,13,0,0,65
SIMPSON STREET,2,19,39,16,1,0,77
SOUNDVIEW AVENUE,2,33,44,12,0,0,91
ST. LAWRENCE AVENUE,0,8,14,8,0,0,30
TREMONT AVENUE,1,28,48,28,0,0,105
WHITLOCK AVENUE,0,3,6,3,0,0,12
WOODLAWN,0,28,35,23,1,0,87
ZEREGA AVENUE,0,3,1,1,0,0,5
15 ST.-PROSPECT PARK,0,2,3,1,0,0,6
18 AVENUE,0,3,5,3,0,0,11
20 AVENUE,0,13,29,3,0,0,45
25 AVENUE,0,0,3,0,0,0,3
25 STREET,0,0,6,3,0,1,10
36 STREET,0,13,27,11,0,0,51
4 AVENUE-9 STREET,0,23,42,13,3,0,81
45 STREET,0,6,5,3,0,0,14
50 STREET,0,0,1,0,0,0,1
53 STREET,0,7,22,13,1,0,43
55 STREET,0,0,0,0,1,0,1
59 STREET,1,10,12,10,0,0,33
62 STREET,0,2,0,0,0,0,2
7 AVENUE,1,9,23,11,0,0,44
71 STREET,0,0,0,1,0,0,1
77 STREET,0,1,1,0,0,0,2
79 STREET,0,1,11,7,0,0,19
7TH AVENUE,2,2,5,2,0,0,11
8 AVENUE,0,2,8,5,1,0,16
86 STREET,0,7,5,7,2,0,21
9 AVENUE,0,0,2,6,0,0,8
9TH STREET,1,3,2,0,0,0,6
ALABAMA AVENUE,0,1,7,5,0,0,13
ATLANTIC AVENUE,3,51,99,29,2,0,184
"AVENUE ""H""",0,0,2,1,0,0,3
"AVENUE ""I""",0,0,0,1,0,0,1
"AVENUE ""J""",0,3,7,2,0,0,12
"AVENUE ""M""",0,0,5,2,0,0,7
"AVENUE ""N""",0,2,3,1,0,0,6
"AVENUE ""U""",0,4,17,7,0,0,28
"AVENUE ""X""",0,0,2,0,0,0,2
BAY 50 STREET,0,2,1,3,0,0,6
BAY PARKWAY,0,2,7,8,0,0,17
BAY RIDGE AVENUE,0,0,1,3,1,0,5
BEDFORD AVENUE,1,17,25,4,0,0,47
BEDFORD-NOSTRAND AVENUES,0,15,17,2,0,0,34
BERGEN STREET,0,16,29,7,0,0,52
BEVERLEY ROAD,0,0,1,0,0,0,1
BEVERLY ROAD,0,4,11,1,0,0,16
BOROUGH HALL,0,5,4,2,0,0,11
BRIGHTON BEACH,0,8,20,13,0,0,41
BROADWAY,0,6,5,2,1,0,14
BROADWAY-EAST NEW YORK,2,10,29,7,0,0,48
BROADWAY-EASTERN PKWY,0,2,4,1,0,0,7
BUSHWICK AVE.-ABERDEEN ST.,1,54,80,11,1,0,147
CARROLL STREET,0,2,1,1,1,0,5
CENTRAL AVENUE,0,0,3,1,0,0,4
CHAUNCEY STREET,0,0,6,1,0,0,7
CHURCH AVENUE,5,58,78,44,5,0,190
CLARK STREET,1,7,10,2,0,0,20
CLASSON AVENUE,0,1,0,0,0,0,1
CLEVELAND STREET,0,0,0,1,0,0,1
CLINTON-WASHINGTON AVENUES,0,18,52,6,1,0,77
CORTELYOU ROAD,1,1,7,1,0,0,10
COURT STREET,0,0,3,0,0,0,3
CRESCENT STREET,0,2,10,1,0,0,13
CYPRESS HILLS,0,0,0,0,1,0,1
DEKALB AVENUE,0,42,56,18,1,0,117
DISTRICT 30 OFFICE,0,1,0,0,0,0,1
DISTRICT 33 OFFICE,1,4,0,2,0,0,7
EAST 105 STREET,0,24,24,3,0,0,51
EASTERN PKWY-BROOKLYN MUSEUM,0,3,6,1,0,0,10
EUCLID AVENUE,1,6,5,2,0,0,14
FLATBUSH AVE.-BROOKLYN COLLEGE,3,30,40,21,0,1,95
FLUSHING AVENUE,0,37,73,18,0,1,129
FORT HAMILTON PKWY,1,8,19,7,0,0,35
FRANKLIN AVENUE,2,45,88,26,1,0,162
FRESH POND ROAD,0,2,4,1,0,0,7
FULTON STREET,0,16,24,7,0,0,47
GATES AVENUE,0,8,9,2,0,0,19
GRAHAM AVENUE,0,15,18,6,0,0,39
GRAND ARMY PLAZA,0,1,6,2,0,0,9
GRAND STREET,0,4,9,1,0,0,14
GRANT AVENUE,0,1,3,0,0,0,4
GREENPOINT AVENUE,0,1,4,0,0,0,5
HALSEY STREET,2,99,153,38,3,0,295
HEWES STREET,0,4,5,1,0,0,10
HIGH STREET,1,1,9,0,0,0,11
HOYT STREET,1,20,10,6,0,0,37
HOYT-SCHERMERHORN,5,27,53,15,1,0,101
JAY STREET-BOROUGH HALL,5,101,84,23,6,1,220
JEFFERSON STREET,6,54,116,17,0,0,193
JUNIUS STREET,6,23,30,6,0,0,65
KINGS HIGHWAY,0,16,35,15,0,1,67
KINGSTON AVENUE,0,7,5,3,0,0,15
KINGSTON-THROOP AVENUES,1,5,24,1,0,0,31
KNICKERBOCKER AVENUE,0,1,2,0,0,0,3
KOSCIUSKO STREET,0,11,16,2,1,0,30
LAFAYETTE AVENUE,0,2,8,2,0,0,12
LIBERTY AVENUE,1,7,18,5,0,0,31
LIVONIA AVENUE,1,18,31,10,3,0,63
LORIMER STREET,3,43,102,9,1,0,158
MARCY AVENUE,0,68,99,12,1,0,180
METROPOLITAN AVENUE,0,15,34,2,0,0,51
MONTROSE AVENUE,0,16,22,8,0,0,46
MORGAN AVENUE,0,13,24,2,0,0,39
MYRTLE AVENUE,0,8,20,4,0,0,32
MYRTLE/WYCKOFF AVENUES,7,269,362,99,5,1,743
MYRTLE-WILLOUGHBY AVENUES,1,34,33,8,2,1,79
NASSAU AVENUE,0,12,21,9,1,0,43
NECK ROAD,0,0,3,0,0,0,3
NEPTUNE AVENUE,0,0,1,1,0,0,2
NEVINS STREET,1,10,25,15,2,0,53
NEW LOTS AVENUE,2,3,17,10,0,0,32
NEW UTRECHT AVENUE,0,1,1,2,0,0,4
NEWKIRK AVENUE,0,14,23,4,0,0,41
NORWOOD AVENUE,0,1,1,0,0,0,2
NOSTRAND AVENUE,3,63,131,30,2,0,229
OCEAN PKWY,0,1,4,0,0,0,5
PACIFIC STREET,0,7,18,5,0,0,30
PARKSIDE AVENUE,0,7,11,0,0,0,18
PENNSYLVANIA AVENUE,2,7,10,6,0,0,25
PRESIDENT STREET,0,1,2,0,0,0,3
PROSPECT AVENUE,0,8,6,3,0,0,17
PROSPECT PARK,0,35,38,8,0,1,82
RALPH AVENUE,0,11,34,3,0,0,48
ROCKAWAY AVENUE,2,31,55,17,0,0,105
ROCKAWAY PKWY-CANARSIE,1,7,11,6,0,0,25
SARATOGA AVENUE,2,21,20,9,1,0,53
SENECA AVENUE,0,4,5,2,0,0,11
SHEEPSHEAD BAY,1,24,34,7,0,0,66
SHEPHERD AVENUE,0,5,7,2,1,0,15
SMITH-9 STREETS,1,26,37,21,1,0,86
STERLING STREET,0,11,21,6,1,0,39
STILLWELL AVENUE-CONEY ISLAND,3,47,153,48,7,0,258
SUTTER AVENUE,1,21,35,9,2,0,68
SUTTER AVENUE-RUTLAND ROAD,2,15,31,9,1,0,58
UNION STREET,0,4,4,1,0,0,9
UTICA AVE.-CROWN HEIGHTS,4,66,98,31,2,1,202
UTICA AVENUE,1,37,56,13,1,0,108
VAN SICLEN AVENUE,1,26,28,9,0,0,64
WEST 8 STREET-NY AQUARIUM,0,0,4,1,0,0,5
WILSON AVENUE,2,24,46,3,0,1,76
WINTHROP STREET,1,9,17,4,1,0,32
WYCKOFF AVENUE,0,1,6,0,0,0,7
YORK STREET,0,1,2,1,0,0,4
1 AVENUE,1,16,29,5,0,0,51
103 STREET,0,6,13,6,0,1,26
110 ST.-CATHEDRAL PKWY.,0,37,50,15,2,1,105
110 ST.-CENTRAL PARK NORTH,0,13,35,14,1,0,63
110 STREET,0,2,3,3,0,0,8
116 ST.-COLUMBIA UNIVERSITY,2,61,26,9,0,1,99
116 STREET,0,40,84,28,3,0,155
125 STREET,7,160,255,109,5,4,540
135 STREET,1,41,72,36,1,0,151
137 ST.-CITY COLLEGE,0,44,63,16,1,0,124
14 ST.-UNION SQUARE,2,28,40,4,0,0,74
14 STREET,26,390,421,109,16,3,965
145 STREET,6,258,320,104,10,1,699
148 ST.-HARLEM,0,0,5,1,0,0,6
155 STREET,0,1,5,3,0,0,9
157 STREET,0,26,28,7,3,0,64
163 ST.-AMSTERDAM AVE.,0,24,38,19,3,0,84
168 ST.-WASHINGTON HTS.,4,60,77,19,1,0,161
175 STREET,2,33,65,22,3,1,126
18 STREET,0,1,1,0,0,0,2
181 STREET,0,7,20,7,1,0,35
190 STREET,0,4,2,1,0,0,7
191 STREET,1,32,58,20,0,0,111
2 AVENUE,2,10,14,0,2,0,28
200 ST.-DYCKMAN ST.,4,79,103,40,4,0,230
207 ST.-INWOOD,1,9,18,7,0,0,35
207 STREET,0,15,12,6,1,0,34
215 STREET,0,3,5,1,0,0,9
225 ST.-MARBLE HILL,0,2,0,2,0,0,4
23 STREET,1,69,98,38,4,1,211
238 STREET,0,2,1,1,0,0,4
242 ST.-VAN CORTLANDT PARK,0,21,24,18,0,0,63
28 STREET,3,115,174,71,6,1,370
3 AVENUE,0,5,4,3,0,0,12
33 STREET,0,48,71,18,7,0,144
34 ST.-HERALD SQ.,16,215,266,74,13,2,586
34 ST.-PENN STATION,14,393,574,193,38,1,1213
34 STREET,4,87,65,20,0,0,176
42 ST.-GRAND CENTRAL,25,478,580,180,27,8,1298
42 ST.-PORT AUTHORITY BUS TERMINAL,26,662,1029,306,35,16,2074
42 ST.-TIMES SQUARE,18,441,550,137,17,5,1168
42 STREET,1,50,82,27,3,2,165
47-50 STS./ROCKEFELLER CTR.,0,41,56,12,0,0,109
49 STREET,0,19,19,7,1,0,46
5 AVENUE,2,17,23,8,0,0,50
50 STREET,0,34,63,20,3,2,122
51 STREET,3,57,70,35,5,2,172
57 STREET,2,17,29,14,2,0,64
59 ST.-COLUMBUS CIRCLE,19,494,558,164,11,7,1253
59 STREET,4,56,85,23,2,0,170
6 AVENUE,0,1,0,1,0,0,2
66 ST.-LINCOLN CENTER,0,6,7,1,0,0,14
68 ST.-HUNTER COLLEGE,1,44,30,12,1,0,88
7 AVENUE,0,4,4,0,0,0,8
72 STREET,1,21,36,16,3,0,77
72ND STREET,2,5,9,2,1,0,19
77 STREET,4,48,74,20,1,2,149
79 STREET,1,5,4,4,2,0,16
8 AVENUE,0,6,0,2,0,0,8
8 ST.-NYU,0,14,7,2,0,0,23
81 ST.-MUSEUM OF NATURAL HISTORY,0,5,2,0,0,0,7
86 STREET,8,122,124,58,6,3,321
86TH STREET,0,4,9,7,0,0,20
96 STREET,4,56,84,51,3,1,199
96TH STREET,1,9,24,9,1,0,44
ASTOR PLACE,0,4,2,1,1,0,8
BLEECKER STREET,2,41,65,30,4,0,142
BOWERY,0,3,2,1,0,0,6
BOWLING GREEN,0,17,28,7,0,0,52
BROADWAY/LAFAYETTE,3,36,63,12,0,2,116
BROADWAY/NASSAU,6,155,243,65,4,0,473
BROOKLYN BRIDGE-CITY HALL,0,5,7,5,1,0,18
CANAL STREET,12,124,131,42,9,0,318
CHAMBERS ST.-WORLD TRADE CENTER,5,46,38,16,2,0,107
CHAMBERS STREET,1,16,26,14,0,0,57
CHRISTOPHER ST.-SHERIDAN SQ.,0,8,9,3,1,0,21
CITY HALL,0,1,1,0,0,0,2
CORTLANDT STREET,0,6,3,1,1,0,11
DELANCEY STREET,1,33,52,27,0,0,113
DISTRICT 1 OFFICE,0,3,3,1,0,0,7
DISTRICT 4 OFFICE,0,3,3,1,0,0,7
EAST BROADWAY,0,7,7,2,0,0,16
ESSEX STREET,0,5,5,0,0,0,10
FRANKLIN STREET,0,2,8,0,1,0,11
FULTON STREET,7,69,70,16,1,1,164
GRAND STREET,0,4,4,1,1,0,10
HOUSTON STREET,0,1,1,0,0,0,2
LEXINGTON AVE.,2,10,14,4,0,0,30
LEXINGTON AVENUE,1,13,23,12,0,0,49
OFF-SYSTEM,0,3,7,2,0,0,12
OFF-SYSTEM,0,3,7,2,0,0,12
PARK PLACE,0,0,1,0,0,0,1
PRINCE STREET,0,4,4,0,1,0,9
RECTOR STREET,0,0,4,0,0,0,4
SOUTH FERRY,0,9,18,5,2,0,34
SPRING STREET,1,18,22,3,1,1,46
UNION SQUARE,7,35,43,7,0,2,94
W. 4 STREET,1,181,190,35,11,0,418
WALL STREET,0,6,6,0,0,0,12
WHITEHALL ST.-SOUTH FERRY,0,2,3,0,0,0,5
102 STREET,0,3,0,0,0,0,3
103 ST.-CORONA PLAZA,3,37,59,16,0,0,115
111 STREET,1,0,0,0,0,0,1
111 st-Roosevelt Ave,0,19,17,7,2,0,45
121 STREET,0,0,2,0,0,0,2
169 STREET,1,31,73,43,2,0,150
179 ST.-JAMAICA,0,10,12,10,0,0,32
21 ST.-QUEENSBRIDGE,0,5,6,4,1,0,16
21 STREET,0,4,1,1,0,0,6
23 STREET-ELY AVENUE,0,4,11,4,0,0,19
30 AVENUE,0,0,1,0,0,0,1
33 STREET,0,2,6,1,0,0,9
36 AVENUE,0,1,0,0,0,0,1
36 STREET,0,0,3,1,0,0,4
39 AVENUE,0,0,2,0,0,0,2
40 STREET,0,3,0,0,0,0,3
45 ROAD-COURT HOUSE SQUARE,0,3,13,5,0,0,21
46 STREET,3,42,74,43,1,0,163
52 STREET,1,3,11,4,0,0,19
61 ST.-WOODSIDE,0,4,7,2,0,0,13
63 DRIVE-REGO PARK,0,2,1,6,0,0,9
65 STREET,0,0,2,1,0,0,3
67 AVENUE,0,1,1,0,0,0,2
69 STREET,0,32,43,14,0,0,89
71 AVE.-FOREST HILLS,3,16,12,8,2,0,41
74 ST.-BROADWAY,1,61,153,47,0,0,262
75 AVENUE,1,1,4,3,0,0,9
75 ST.-ELDERTS LANE,0,3,6,2,0,0,11
80 STREET,0,6,8,4,0,0,18
82 ST.-JACKSON HEIGHTS,0,20,45,9,2,0,76
85 ST.-FOREST PKWY.,0,3,0,3,0,0,6
88 STREET,0,1,0,1,0,0,2
90 ST.-ELMHURST AVE.,1,31,90,59,1,0,182
AQUEDUCT-NORTH CONDUIT AVE.,0,0,0,1,0,0,1
AQUEDUCT-RACETRACK,0,0,3,1,0,0,4
ASTORIA BLVD.,1,25,28,15,0,0,69
BEACH 25 STREET,0,1,3,1,0,0,5
BEACH 36 STREET,0,1,1,0,0,0,2
BEACH 60 STREET,0,0,6,0,2,0,8
BEACH 67 STREET,0,1,7,4,0,0,12
BEACH 90 STREET,0,1,0,0,0,0,1
BEACH 98 STREET,0,3,2,0,0,0,5
BROADWAY,0,2,7,0,0,0,9
COURT SQUARE,1,8,10,1,0,0,20
DISTRICT 20 OFFICE,0,0,1,0,0,0,1
DITMARS BLVD.-ASTORIA,1,7,11,4,0,0,23
ELMHURST AVE.,1,11,18,10,0,0,40
FAR ROCKAWAY-MOTT AVE.,1,53,81,24,2,0,161
GRAND AVE.-NEWTON,0,3,9,7,0,1,20
HOWARD BEACH-JFK AIRPORT,0,0,1,1,0,0,2
HUNTERS POINT AVENUE,0,0,0,2,0,0,2
JAMAICA-VAN WYCK,0,0,2,2,0,0,4
JUNCTION BLVD.,1,49,92,30,2,0,174
LEFFERTS BLVD.,0,7,18,9,1,0,35
MAIN ST.-FLUSHING,8,138,196,67,4,0,413
NORTHERN BLVD.,0,0,0,1,0,0,1
OFF-SYSTEM,0,0,2,0,0,0,2
OFF-SYSTEM,0,0,2,0,0,0,2
PARSONS BLVD.,1,12,59,29,2,0,103
PARSONS/ARCHER-JAMAICA CENTER,0,17,28,11,2,0,58
QUEENS PLAZA,0,9,14,2,2,0,27
QUEENSBORO PLAZA,1,17,26,8,0,0,52
ROCKAWAY BLVD.,3,34,44,18,2,0,101
ROCKAWAY PARK-BEACH 116 ST.,0,2,0,0,0,0,2
ROOSEVELT AVE.-JACKSON HEIGHTS,5,191,338,166,10,0,710
ROOSEVELT ISLAND,0,0,1,0,0,0,1
STEINWAY ST.,0,10,18,5,0,0,33
SUTPHIN BLVD.,2,16,56,24,4,1,103
SUTPHIN BLVD.-ARCHER AVE.,0,35,109,42,7,0,193
UNION TURNPIKE-KEW GARDENS,4,63,65,32,2,0,166
VAN WYCK BLVD.-BRIARWOOD,1,4,15,3,1,0,24
VERNON BLVD.-JACKSON AVE.,0,0,1,1,0,0,2
WILLETS POINT-SHEA STADIUM,1,14,14,9,1,0,39
WOODHAVEN BLVD.,4,70,106,40,0,1,221
